   oo   ooo   ooo   ooo  
     o o   o o   o o   o 
o     o     o     o     o
o     o     o     o     o
oo    o     o     o     o
ooo   o     oo    o   o o
#o#########o#############
#o#o###################o#
########################D
#########################
#####################o###
